 134 143 150 151 149 153 157 157 155 159 165 163 161 167 174 176
 138 146 151 154 154 158 160 163 162 166 167 169 170 174 177 179
 138 149 150 139 148 158 156 155 147 164 163 166 162 173 177 178
 142 145 139  24  28  24  29  29  27  27  29  35  35 153 175 178
 142 146 133  44 132  31 158 151  27 162 164 169  41 157 178 181
 135 146 140  37 132  42 148  38  27 168  32 162  47 163 178 180
 142 146 144  28 153 155 160 162 151 161  33 155 169 174 175 181
 142 146 137  23  38  35  41 161  56  45  26 161  67 150 175 181
 137 145 140  49 124  35 152 162 146 149  29 164  48 166 177 181
 143 146 150 139 141  23  46 155  62 164  34 160  56 159 176 180
 139 147 133  59 137  28 142 161  26 162  36 149  60 148 175 180
 135 143 133  38 146 133 157 162  25 160 141 171  47 150 173 181
 139 145 141  26  39  38  34  51  26  57  60  58  30 157 177 181
 131 136 143 112 115 128 138 130 132 138 144 143 142 170 175 178
 131 135 140 138 142 154 157 161 161 164 166 167 170 174 176 179
 125 131 134 143 139 153 154 158 159 163 162 165 166 169 170 176
 133 137 142 144 143 147 149 147 148 152 157 155 152 157 164 167
 137 140 140 145 145 149 150 152 153 156 158 159 160 162 163 167
 136 141 143 135 138 147 148 147 140 156 154 154 152 163 165 167
 139 140 132  24  25  22  23  28  27  23  25  29  32 147 164 166
 136 141 124  46 122  31 148 147  27 152 155 158  37 147 165 168
 133 139 130  39 123  38 140  31  25 156  31 153  42 151 165 167
 139 139 133  33 145 145 151 153 143 153  32 145 156 161 163 166
 137 138 123  25  36  34  38 152  51  42  27 152  61 142 164 169
 133 138 130  46 116  36 144 152 138 139  30 155  40 154 165 169
 136 139 142 133 129  26  43 145  58 154  31 150  46 147 164 168
 136 138 123  59 131  30 134 150  28 151  31 142  56 139 165 168
 133 136 123  42 141 126 150 152  29 151 131 160  42 142 164 167
 133 137 129  27  38  38  32  49  28  53  55  53  27 147 164 167
 122 125 128 101 107 120 128 121 124 126 133 134 130 158 163 165
 119 123 123 121 131 145 145 150 153 155 154 157 157 161 162 165
 115 122 122 128 129 143 149 150 152 153 153 157 157 159 160 165
 115 115 121 121 123 126 133 127 126 127 132 133 129 130 134 133
 119 117 121 119 123 125 127 127 125 128 130 130 133 134 133 129
 120 119 120 113 120 128 125 120 116 133 130 132 129 132 133 135
 123 121 106  16  18  19  18  19  20  17  18  26  25 116 127 132
 121 120 102  40 105  24 123 124  24 129 130 133  28 121 131 136
 114 120 110  36 103  32 109  17  20 128  22 129  30 123 129 132
 120 119 114  32 129 125 129 127 121 123  29 129 134 132 129 128
 120 120 104  24  31  28  29 122  37  33  22 127  49 114 131 130
 118 122 104  39  99  35 128 123 116 118  23 128  31 132 133 132
 122 117 120 115 103  21  41 121  51 131  25 123  36 124 131 128
 121 116 103  54 105  22 116 124  25 125  23 118  45 113 133 132
 117 119 101  41 121 110 131 126  19 133 109 133  31 111 130 133
 115 112 102  21  35  34  27  37  22  45  40  41  23 121 129 133
  86  86  88  67  70  94 107  98  99  99 104 110 107 127 128 130
  78  79  78  75  75 112 120 123 122 127 129 132 132 133 130 131
  78  85  85  87  87 118 123 125 128 128 131 132 135 134 131 134

 176 179 178 178 181 180 181 181 181 180 180 181 181 178 179 176
 174 177 177 175 178 178 175 175 177 176 175 173 177 175 176 170
 167 174 173 153 157 163 174 150 166 159 148 150 157 170 174 169
 161 170 162  35  41  47 169  67  48  56  60  47  30 142 170 166
 163 169 166  35 169 162 155 161 164 160 149 171  58 143 167 165
 165 167 163  29 164  32  33  26  29  34  36 141  60 144 166 162
 159 166 164  27 162 168 161  45 149 164 162 160  57 138 164 163
 155 162 147  27  27  27 151  56 146  62  26  25  26 132 161 159
 157 163 155  29 151  38 162 161 162 155 161 162  51 130 161 158
 157 160 156  29 158 148 160  41 152  46 142 157  34 138 157 154
 153 158 158  24  31  42 155  35  35  23  28 133  38 128 154 153
 149 154 148  28 132 132 153  38 124 141 137 146  39 115 142 139
 151 154 139  24  44  37  28  23  49 139  59  38  26 112 138 143
 150 151 150 139 133 140 144 137 140 150 133 133 141 143 140 134
 143 146 149 145 146 146 146 146 145 146 147 143 145 136 135 131
 134 138 138 142 142 135 142 142 137 143 139 135 139 131 131 125
 167 167 167 166 168 167 166 169 169 168 168 167 167 165 165 165
 164 163 165 164 165 165 163 164 165 164 165 164 164 163 162 160
 157 162 163 147 147 151 161 142 154 147 139 142 147 158 161 159
 152 160 152  32  37  42 156  61  40  46  56  42  27 130 157 157
 155 159 154  29 158 153 145 152 155 150 142 160  53 134 157 157
 157 158 154  25 155  31  32  27  30  31  31 131  55 133 154 153
 152 156 156  23 152 156 153  42 139 154 151 151  53 126 155 153
 148 153 140  27  27  25 143  51 138  58  28  29  28 124 153 152
 147 152 147  28 147  31 153 152 152 145 150 152  49 121 150 150
 149 150 148  23 148 140 151  38 144  43 134 150  32 128 145 149
 147 149 147  22  31  38 145  34  36  26  30 126  38 120 145 143
 143 145 138  25 122 123 145  36 116 129 131 141  38 107 131 129
 144 145 135  24  46  39  33  25  46 133  59  42  27 101 121 128
 142 140 143 132 124 130 133 123 130 142 123 123 129 128 123 122
 137 140 141 140 141 139 139 138 138 139 138 136 137 125 123 122
 133 137 136 139 136 133 139 137 133 136 136 133 133 122 119 115
 133 129 135 132 136 132 128 130 132 128 132 133 133 130 131 134
 134 133 133 127 131 129 129 131 133 131 133 130 129 128 130 131
 130 134 132 116 121 123 132 114 132 124 113 111 121 127 133 134
 129 133 129  25  28  30 134  49  31  36  45  31  23 107 132 135
 133 130 132  26 133 129 129 127 128 123 118 133  41 110 132 132
 132 130 130  18 130  22  29  22  23  25  23 109  40 104 129 131
 127 128 133  17 129 128 123  33 118 131 125 133  45  99 127 128
 126 125 116  20  24  20 121  37 116  51  25  19  22  99 122 128
 127 127 120  19 124  17 127 122 123 121 124 126  37  98 123 125
 133 127 125  18 123 109 129  29 128  41 116 131  27 107 120 123
 126 125 128  19  24  32 125  28  35  21  22 110  34  94 112 118
 123 123 120  18 105 103 129  31  99 103 105 121  35  70  75  87
 121 119 113  16  40  36  32  24  39 115  54  41  21  67  75  87
 121 121 120 106 102 110 114 104 104 120 103 101 102  88  78  85
 115 117 119 121 120 120 119 120 122 117 116 119 112  86  79  85
 115 119 120 123 121 114 120 120 118 122 121 117 115  86  78  78

 176 170 169 166 165 162 163 159 158 154 153 139 143 134 131 125
 179 176 174 170 167 166 164 161 161 157 154 142 138 140 135 131
 178 175 170 142 143 144 138 132 130 138 128 115 112 143 136 131
 181 177 157  30  58  60  57  26  51  34  38  39  26 141 145 139
 181 173 150  47 171 141 160  25 162 157 133 146  38 133 143 135
 180 175 148  60 149  36 162  26 161 142  28 137  59 133 147 139
 180 176 159  56 160  34 164  62 155  46  23 141 139 150 146 143
 181 177 166  48 164  29 149 146 162 152  35 124  49 140 145 137
 181 175 150  67 161  26  45  56 161  41  35  38  23 137 146 142
 181 175 174 169 155  33 161 151 162 160 155 153  28 144 146 142
 180 178 163  47 162  32 168  27  38 148  42 132  37 140 146 135
 181 178 157  41 169 164 162  27 151 158  31 132  44 133 146 142
 178 175 153  35  35  29  27  27  29  29  24  28  24 139 145 142
 178 177 173 162 166 163 164 147 155 156 158 148 139 150 149 138
 179 177 174 170 169 167 166 162 163 160 158 154 154 151 146 138
 176 174 167 161 163 165 159 155 157 157 153 149 151 150 143 134
 165 160 159 157 157 153 153 152 150 149 143 129 128 122 122 115
 165 162 161 157 157 154 155 153 150 145 145 131 121 123 123 119
 165 163 158 130 134 133 126 124 121 128 120 107 101 128 125 122
 167 164 147  27  53  55  53  28  49  32  38  38  27 129 137 133
 167 164 142  42 160 131 151  29 152 150 126 141  42 123 136 133
 168 165 139  56 142  31 151  28 150 134  30 131  59 123 138 136
 168 164 147  46 150  31 154  58 145  43  26 129 133 142 139 136
 169 165 154  40 155  30 139 138 152 144  36 116  46 130 138 133
 169 164 142  61 152  27  42  51 152  38  34  36  25 123 138 137
 166 163 161 156 145  32 153 143 153 151 145 145  33 133 139 139
 167 165 151  42 153  31 156  25  31 140  38 123  39 130 139 133
 168 165 147  37 158 155 152  27 147 148  31 122  46 124 141 136
 166 164 147  32  29  25  23  27  28  23  22  25  24 132 140 139
 167 165 163 152 154 154 156 140 147 148 147 138 135 143 141 136
 167 163 162 160 159 158 156 153 152 150 149 145 145 140 140 137
 167 164 157 152 155 157 152 148 147 149 147 143 144 142 137 133
 134 131 134 135 132 131 128 128 125 123 118  87  87  85  85  78
 131 130 133 132 132 129 127 122 123 120 112  75  75  78  79  78
 130 128 127 107 110 104  99  99  98 107  94  70  67  88  86  86
 133 129 121  23  41  40  45  22  37  27  34  35  21 102 112 115
 133 130 111  31 133 109 133  19 126 131 110 121  41 101 119 117
 132 133 113  45 118  23 125  25 124 116  22 105  54 103 116 121
 128 131 124  36 123  25 131  51 121  41  21 103 115 120 117 122
 132 133 132  31 128  23 118 116 123 128  35  99  39 104 122 118
 130 131 114  49 127  22  33  37 122  29  28  31  24 104 120 120
 128 129 132 134 129  29 123 121 127 129 125 129  32 114 119 120
 132 129 123  30 129  22 128  20  17 109  32 103  36 110 120 114
 136 131 121  28 133 130 129  24 124 123  24 105  40 102 120 121
 132 127 116  25  26  18  17  20  19  18  19  18  16 106 121 123
 135 133 132 129 132 130 133 116 120 125 128 120 113 120 119 120
 129 133 134 133 130 130 128 125 127 127 125 123 119 121 117 119
 133 134 130 129 133 132 127 126 127 133 126 123 121 121 115 115

 125 131 131 139 135 139 143 137 142 142 135 142 142 138 138 134
 131 135 136 145 143 147 146 145 146 146 146 146 145 149 146 143
 134 140 143 141 133 133 150 140 137 144 140 133 139 150 151 150
 143 138 112  26  38  59 139  49  23  28  37  44  24 139 154 151
 139 142 115  39 146 137 141 124  38 153 132 132  28 148 154 149
 153 154 128  38 133  28  23  35  35 155  42  31  24 158 158 153
 154 157 138  34 157 142  46 152  41 160 148 158  29 156 160 157
 158 161 130  51 162 161 155 162 161 162  38 151  29 155 163 157
 159 161 132  26  25  26  62 146  56 151  27  27  27 147 162 155
 163 164 138  57 160 162 164 149  45 161 168 162  27 164 166 159
 162 166 144  60 141  36  34  29  26  33  32 164  29 163 167 165
 165 167 143  58 171 149 160 164 161 155 162 169  35 166 169 163
 166 170 142  30  47  60  56  48  67 169  47  41  35 162 170 161
 169 174 170 157 150 148 159 166 150 174 163 157 153 173 174 167
 170 176 175 177 173 175 176 177 175 175 178 178 175 177 177 174
 176 179 178 181 181 180 180 181 181 181 180 181 178 178 179 176
 115 119 122 133 133 136 136 133 137 139 133 136 139 136 137 133
 122 123 125 137 136 138 139 138 138 139 139 141 140 141 140 137
 122 123 128 129 123 123 142 130 123 133 130 124 132 143 140 142
 128 121 101  27  42  59 133  46  25  33  39  46  24 135 145 144
 129 131 107  38 141 131 129 116  36 145 123 122  25 138 145 143
 143 145 120  38 126  30  26  36  34 145  38  31  22 147 149 147
 149 145 128  32 150 134  43 144  38 151 140 148  23 148 150 149
 150 150 121  49 152 150 145 152 152 153  31 147  28 147 152 147
 152 153 124  28  29  28  58 138  51 143  25  27  27 140 153 148
 153 155 126  53 151 151 154 139  42 153 156 152  23 156 156 152
 153 154 133  55 131  31  31  30  27  32  31 155  25 154 158 157
 157 157 134  53 160 142 150 155 152 145 153 158  29 154 159 155
 157 157 130  27  42  56  46  40  61 156  42  37  32 152 160 152
 159 161 158 147 142 139 147 154 142 161 151 147 147 163 162 157
 160 162 163 164 164 165 164 165 164 163 165 165 164 165 163 164
 165 165 165 167 167 168 168 169 169 166 167 168 166 167 167 167
  78  78  86 115 117 121 122 118 120 120 114 121 123 120 119 115
  85  79  86 112 119 116 117 122 120 119 120 120 121 119 117 115
  85  78  88 102 101 103 120 104 104 114 110 102 106 120 121 121
  87  75  67  21  41  54 115  39  24  32  36  40  16 113 119 121
  87  75  70  35 121 105 103  99  31 129 103 105  18 120 123 123
 118 112  94  34 110  22  21  35  28 125  32  24  19 128 125 126
 123 120 107  27 131 116  41 128  29 129 109 123  18 125 127 133
 125 123  98  37 126 124 121 123 122 127  17 124  19 120 127 127
 128 122  99  22  19  25  51 116  37 121  20  24  20 116 125 126
 128 127  99  45 133 125 131 118  33 123 128 129  17 133 128 127
 131 129 104  40 109  23  25  23  22  29  22 130  18 130 130 132
 132 132 110  41 133 118 123 128 127 129 129 133  26 132 130 133
 135 132 107  23  31  45  36  31  49 134  30  28  25 129 133 129
 134 133 127 121 111 113 124 132 114 132 123 121 116 132 134 130
 131 130 128 129 130 133 131 133 131 129 129 131 127 133 133 134
 134 131 130 133 133 132 128 132 130 128 132 136 132 135 129 133

