 178 179 177 176 170 173 171 168 167 168 164 165 163 162 162 152
 196 202 203 203 204 205 206 208 210 208 208 209 209 209 210 201
 199 204 203 206 209 208 208 207 209 211 209 207 211 212 213 201
 205 205 206 209 208 207 208 213 213 213 215 211 212 216 214 204
 203 206 206 209 208 210 213 215 214 215 212 212 211 215 214 202
 202 207 209 210 211 212 214 216 214 215 215 214 215 213 214 201
 203 207 210 210 209 214 212 211 214 216 214 214 216 217 213 204
 208 211 210 212 213 214 215 216 217 216 214 217 217 217 216 203
 206 209 211 212 216 212 216 216 215 217 217 218 219 216 215 201
 209 210 212 213 214 216 214 216 217 216 220 221 219 218 219 202
 209 212 213 214 218 215 214 214 218 216 219 217 218 217 219 208
 210 212 212 218 218 218 216 218 219 218 147 189 157 154 156 223
 209 214 215 216 215 218 218 216 217 216 132 146 135 141 141 219
 211 212 211 214 216 216 218 219 219 219 107 178 157 157 111 214
 210 215 215 215 215 215 218 222 217 221 152 191 190 188 143 217
 211 215 212 214 213 214 213 216 218 219 125 180 113 145 138 216
 185 188 187 184 180 180 178 176 176 174 170 169 167 166 165 157
 205 207 208 208 207 208 209 211 212 211 210 211 210 209 209 203
 202 206 207 207 209 208 211 211 212 212 210 209 211 213 211 203
 206 206 209 209 210 209 211 213 213 212 215 212 212 212 213 201
 205 208 210 211 209 210 212 213 213 214 211 210 211 215 213 200
 206 209 210 211 211 212 213 215 212 214 213 213 214 211 212 199
 206 209 211 211 212 211 211 212 213 215 212 212 215 212 211 200
 210 211 210 211 212 212 213 213 214 214 213 216 214 211 214 199
 208 211 210 211 216 211 216 215 213 215 216 215 214 213 212 197
 209 209 210 210 213 215 212 213 214 212 214 215 214 214 214 194
 208 211 212 213 214 214 213 213 215 214 215 212 213 211 212 199
 211 212 212 213 212 213 214 213 213 211 142 182 151 147 146 211
 210 212 212 212 211 214 213 212 213 211 127 139 130 133 134 210
 210 211 213 213 212 212 215 214 213 210  95 169 145 148 106 207
 210 211 213 212 211 211 211 213 210 211 141 181 178 175 136 209
 209 212 209 209 208 210 209 208 208 208 115 170 103 133 126 206
 196 197 196 193 189 189 188 186 183 181 177 177 177 174 176 162
 209 210 211 210 213 213 211 214 213 211 213 216 215 213 212 204
 208 210 210 213 212 210 212 211 212 210 208 209 211 212 213 200
 212 209 212 211 211 210 209 213 211 211 210 209 210 214 209 197
 208 210 212 213 211 212 211 212 209 212 210 210 209 210 208 196
 211 212 211 210 209 210 213 213 213 212 211 210 209 212 210 196
 209 211 208 207 209 210 210 210 211 211 211 210 210 213 206 194
 210 211 209 208 210 211 211 211 209 211 211 209 209 210 207 192
 210 209 209 208 208 209 211 210 208 210 211 209 210 208 204 187
 212 206 209 210 209 209 207 208 207 208 207 205 206 204 203 189
 210 207 206 204 206 207 207 205 206 206 206 203 205 203 206 187
 209 205 206 204 204 205 206 207 204 205 138 177 142 138 137 195
 205 207 203 200 200 203 203 203 201 199 122 134 118 121 125 195
 206 199 200 201 200 198 195 196 197 193  86 159 140 140  91 190
 200 198 197 195 196 198 196 197 191 192 126 165 164 160 121 186
 199 196 192 195 191 191 189 193 189 187 101 153  85 119 109 181

 152 201 201 204 202 201 204 203 201 202 208 223 219 214 217 216
 162 210 213 214 214 214 213 216 215 219 219 156 141 111 143 138
 162 209 212 216 215 213 217 217 216 218 217 154 141 157 188 145
 163 209 211 212 211 215 216 217 219 219 218 157 135 157 190 113
 165 209 207 211 212 214 214 217 218 221 217 189 146 178 191 180
 164 208 209 215 212 215 214 214 217 220 219 147 132 107 152 125
 168 208 211 213 215 215 216 216 217 216 216 218 216 219 221 219
 167 210 209 213 214 214 214 217 215 217 218 219 217 219 217 218
 168 208 207 213 215 216 211 216 216 216 214 218 216 219 222 216
 171 206 208 208 213 214 212 215 216 214 214 216 218 218 218 213
 173 205 208 207 210 212 214 214 212 216 215 218 218 216 215 214
 170 204 209 208 208 211 209 213 216 214 218 218 215 216 215 213
 176 203 206 209 209 210 210 212 212 213 214 218 216 214 215 214
 177 203 203 206 206 209 210 210 211 212 213 212 215 211 215 212
 179 202 204 205 206 207 207 211 209 210 212 212 214 212 215 215
 178 196 199 205 203 202 203 208 206 209 209 210 209 211 210 211
 157 203 203 201 200 199 200 199 197 194 199 211 210 207 209 206
 165 209 211 213 213 212 211 214 212 214 212 146 134 106 136 126
 166 209 213 212 215 211 212 211 213 214 211 147 133 148 175 133
 167 210 211 212 211 214 215 214 214 214 213 151 130 145 178 103
 169 211 209 212 210 213 212 216 215 215 212 182 139 169 181 170
 170 210 210 215 211 213 212 213 216 214 215 142 127  95 141 115
 174 211 212 212 214 214 215 214 215 212 214 211 211 210 211 208
 176 212 212 213 213 212 213 214 213 214 215 213 213 213 210 208
 176 211 211 213 213 215 212 213 215 213 213 213 212 214 213 208
 178 209 211 211 212 213 211 213 216 212 213 214 213 215 211 209
 180 208 208 209 210 212 211 212 211 215 214 213 214 212 211 210
 180 207 209 210 209 211 212 212 216 213 214 212 211 212 211 208
 184 208 207 209 211 211 211 211 211 210 213 213 212 213 212 209
 187 208 207 209 210 210 211 210 210 210 212 212 212 213 213 209
 188 207 206 206 208 209 209 211 211 209 211 212 212 211 211 212
 185 205 202 206 205 206 206 210 208 209 208 211 210 210 210 209
 162 204 200 197 196 196 194 192 187 189 187 195 195 190 186 181
 176 212 213 209 208 210 206 207 204 203 206 137 125  91 121 109
 174 213 212 214 210 212 213 210 208 204 203 138 121 140 160 119
 177 215 211 210 209 209 210 209 210 206 205 142 118 140 164  85
 177 216 209 209 210 210 210 209 209 205 203 177 134 159 165 153
 177 213 208 210 210 211 211 211 211 207 206 138 122  86 126 101
 181 211 210 211 212 212 211 211 210 208 206 205 199 193 192 187
 183 213 212 211 209 213 211 209 208 207 206 204 201 197 191 189
 186 214 211 213 212 213 210 211 210 208 205 207 203 196 197 193
 188 211 212 209 211 213 210 211 211 207 207 206 203 195 196 189
 189 213 210 210 212 210 210 211 209 209 207 205 203 198 198 191
 189 213 212 211 211 209 209 210 208 209 206 204 200 200 196 191
 193 210 213 211 213 210 207 208 208 210 204 204 200 201 195 195
 196 211 210 212 212 211 208 209 209 209 206 206 203 200 197 192
 197 210 210 209 210 212 211 211 209 206 207 205 207 199 198 196
 196 209 208 212 208 211 209 210 210 212 210 209 205 206 200 199

 216 138 145 113 180 125 219 218 216 213 214 213 214 212 215 211
 217 143 188 190 191 152 221 217 222 218 215 215 215 215 215 210
 214 111 157 157 178 107 219 219 219 218 216 216 214 211 212 211
 219 141 141 135 146 132 216 217 216 218 218 215 216 215 214 209
 223 156 154 157 189 147 218 219 218 216 218 218 218 212 212 210
 208 219 217 218 217 219 216 218 214 214 215 218 214 213 212 209
 202 219 218 219 221 220 216 217 216 214 216 214 213 212 210 209
 201 215 216 219 218 217 217 215 216 216 212 216 212 211 209 206
 203 216 217 217 217 214 216 217 216 215 214 213 212 210 211 208
 204 213 217 216 214 214 216 214 211 212 214 209 210 210 207 203
 201 214 213 215 214 215 215 214 216 214 212 211 210 209 207 202
 202 214 215 211 212 212 215 214 215 213 210 208 209 206 206 203
 204 214 216 212 211 215 213 213 213 208 207 208 209 206 205 205
 201 213 212 211 207 209 211 209 207 208 208 209 206 203 204 199
 201 210 209 209 209 208 208 210 208 206 205 204 203 203 202 196
 152 162 162 163 165 164 168 167 168 171 173 170 176 177 179 178
 206 126 133 103 170 115 208 208 208 209 210 208 209 209 212 209
 209 136 175 178 181 141 211 210 213 211 211 211 212 213 211 210
 207 106 148 145 169  95 210 213 214 215 212 212 213 213 211 210
 210 134 133 130 139 127 211 213 212 213 214 211 212 212 212 210
 211 146 147 151 182 142 211 213 213 214 213 212 213 212 212 211
 199 212 211 213 212 215 214 215 213 213 214 214 213 212 211 208
 194 214 214 214 215 214 212 214 213 212 215 213 210 210 209 209
 197 212 213 214 215 216 215 213 215 216 211 216 211 210 211 208
 199 214 211 214 216 213 214 214 213 213 212 212 211 210 211 210
 200 211 212 215 212 212 215 213 212 211 211 212 211 211 209 206
 199 212 211 214 213 213 214 212 215 213 212 211 211 210 209 206
 200 213 215 211 210 211 214 213 213 212 210 209 211 210 208 205
 201 213 212 212 212 215 212 213 213 211 209 210 209 209 206 206
 203 211 213 211 209 210 212 212 211 211 208 209 207 207 206 202
 203 209 209 210 211 210 211 212 211 209 208 207 208 208 207 205
 157 165 166 167 169 170 174 176 176 178 180 180 184 187 188 185
 181 109 119  85 153 101 187 189 193 189 191 191 195 192 196 199
 186 121 160 164 165 126 192 191 197 196 198 196 195 197 198 200
 190  91 140 140 159  86 193 197 196 195 198 200 201 200 199 206
 195 125 121 118 134 122 199 201 203 203 203 200 200 203 207 205
 195 137 138 142 177 138 205 204 207 206 205 204 204 206 205 209
 187 206 203 205 203 206 206 206 205 207 207 206 204 206 207 210
 189 203 204 206 205 207 208 207 208 207 209 209 210 209 206 212
 187 204 208 210 209 211 210 208 210 211 209 208 208 209 209 210
 192 207 210 209 209 211 211 209 211 211 211 210 208 209 211 210
 194 206 213 210 210 211 211 211 210 210 210 209 207 208 211 209
 196 210 212 209 210 211 212 213 213 213 210 209 210 211 212 211
 196 208 210 209 210 210 212 209 212 211 212 211 213 212 210 208
 197 209 214 210 209 210 211 211 213 209 210 211 211 212 209 212
 200 213 212 211 209 208 210 212 211 212 210 212 213 210 210 208
 204 212 213 215 216 213 211 213 214 211 213 213 210 211 210 209
 162 176 174 177 177 177 181 183 186 188 189 189 193 196 197 196

 211 210 211 209 210 209 209 206 208 203 202 203 205 199 196 178
 215 215 212 214 212 212 210 209 211 207 207 206 205 204 202 179
 212 215 211 215 212 213 212 211 210 210 209 206 206 203 203 177
 214 215 214 216 218 214 213 212 212 210 210 209 209 206 203 176
 213 215 216 215 218 218 214 216 213 209 211 208 208 209 204 170
 214 215 216 218 218 215 216 212 214 214 212 210 207 208 205 173
 213 218 218 218 216 214 214 216 215 212 214 213 208 208 206 171
 216 222 219 216 218 214 216 216 216 211 216 215 213 207 208 168
 218 217 219 217 219 218 217 215 217 214 214 214 213 209 210 167
 219 221 219 216 218 216 216 217 216 216 215 215 213 211 208 168
 125 152 107 132 147 219 220 217 214 214 215 212 215 209 208 164
 180 191 178 146 189 217 221 218 217 214 214 212 211 207 209 165
 113 190 157 135 157 218 219 219 217 216 215 211 212 211 209 163
 145 188 157 141 154 217 218 216 217 217 213 215 216 212 209 162
 138 143 111 141 156 219 219 215 216 213 214 214 214 213 210 162
 216 217 214 219 223 208 202 201 203 204 201 202 204 201 201 152
 209 210 210 210 211 208 209 208 210 206 206 205 206 202 205 185
 212 211 211 212 212 211 209 211 211 209 209 208 206 206 207 188
 209 213 213 212 212 212 210 210 210 211 210 210 209 207 208 187
 209 212 213 212 213 213 210 211 211 211 211 211 209 207 208 184
 208 211 212 211 212 214 213 216 212 212 211 209 210 209 207 180
 210 211 212 214 213 214 215 211 212 211 212 210 209 208 208 180
 209 211 215 213 214 213 212 216 213 211 213 212 211 211 209 178
 208 213 214 212 213 213 213 215 213 212 215 213 213 211 211 176
 208 210 213 213 213 215 214 213 214 213 212 213 213 212 212 176
 208 211 210 211 211 214 212 215 214 215 214 214 212 212 211 174
 115 141  95 127 142 215 214 216 213 212 213 211 215 210 210 170
 170 181 169 139 182 212 215 215 216 212 213 210 212 209 211 169
 103 178 145 130 151 213 214 214 214 215 214 211 212 211 210 167
 133 175 148 133 147 211 214 213 211 212 211 215 212 213 209 166
 126 136 106 134 146 212 214 212 214 211 212 213 213 211 209 165
 206 209 207 210 211 199 194 197 199 200 199 200 201 203 203 157
 199 200 206 205 209 210 212 210 210 209 211 208 212 208 209 196
 196 198 199 207 205 207 206 209 211 211 212 210 209 210 210 197
 192 197 200 203 206 206 209 209 209 208 211 212 212 210 211 196
 195 195 201 200 204 204 210 208 208 207 210 213 211 213 210 193
 191 196 200 200 204 206 209 208 210 209 209 211 211 212 213 189
 191 198 198 203 205 207 209 209 211 210 210 212 210 210 213 189
 189 196 195 203 206 207 207 211 211 210 213 211 209 212 211 188
 193 197 196 203 207 205 208 210 211 210 213 212 213 211 214 186
 189 191 197 201 204 206 207 208 209 211 213 209 211 212 213 183
 187 192 193 199 205 206 208 210 211 211 212 212 211 210 211 181
 101 126  86 122 138 206 207 211 211 211 211 210 210 208 213 177
 153 165 159 134 177 203 205 209 209 210 210 210 209 209 216 177
  85 164 140 118 142 205 206 210 209 210 209 209 210 211 215 177
 119 160 140 121 138 203 204 208 210 213 212 210 214 212 213 174
 109 121  91 125 137 206 203 204 207 206 210 208 209 213 212 176
 181 186 190 195 195 187 189 187 192 194 196 196 197 200 204 162

